10
G.G.-.W.-.-.W.-.-.-
-.-.-.-.-.W.-.W.G.-
-.-.W.-.-.-.-.W.W.-
-.-.-.-.-.-.-.-.-.-
W.-.W.-.A.-.-.-.W.-
-.W.-.-.-.-.-.-.-.-
-.-.-.-.-.-.W.-.-.-
W.-.-.-.-.-.-.W.-.-
-.-.-.W.-.-.-.-.-.-
-.-.-.-.-.W.-.-.W.-
