10
G.G.-.-.P.-.-.-.-.-
-.-.-.-.P.W.-.-.G.-
-.-.W.-.P.-.-.-.-.-
-.P.-.-.-.-.-.-.-.-
P.-.-.-.-.-.-.-.-.-
-.-.-.-.G.-.-.-.-.-
-.W.-.P.-.-.P.-.-.-
P.-.-.-.-.-.-.G.-.-
G.G.W.-.-.-.-.-.P.-
A.G.-.-.-.G.-.-.-.-
