10
G.G.-.-.P.-.-.-.-.-
-.-.-.-.P.W.-.-.G.-
-.-.W.-.P.-.P.P.P.P
-.P.-.-.-.-.-.-.-.-
P.-.-.-.A.G.-.-.-.-
-.-.-.-.G.-.-.-.-.-
-.-.-.-.-.-.-.-.-.-
P.-.-.-.-.-.-.-.-.-
G.G.-.-.-.-.-.-.P.-
W.G.-.-.-.-.-.-.-.G