10
W.G.-.-.-.-.-.-.-.-
-.-.-.-.-.G.-.-.G.-
-.-.W.-.P.W.-.W.-.-
-.W.-.-.-.-.-.-.-.-
-.-.-.-.-.-.-.-.-.-
-.-.-.-.G.-.-.-.-.-
-.-.-.-.-.-.P.-.-.-
W.-.-.-.-.-.-.G.-.-
-.-.-.-.-.-.-.-.W.-
A.-.-.-.-.-.-.-.-.-
