10
G.G.-.-.P.-.-.-.-.-
-.-.-.-.P.W.-.-.G.-
-.-.W.-.P.-.-.-.-.-
-.P.-.-.-.-.-.-.-.-
P.-.-.-.-.-.-.-.-.-
-.-.-.-.G.-.-.-.-.-
-.-.-.-.-.-.P.-.-.-
P.-.-.-.-.-.-.G.-.-
G.G._.-.-.-.-.-.P.-
A.G.-.-.-.G.-.-.-.-
