10
-.-.-.-.P.-.-.-.-.-
-.-.-.-.P.P.P.-.G.-
-.-.-.-.W.-.P.P.W.P
-.P.P.P.-.W.P.-.-.-
-.-.P.-.A.-.P.-.-.-
-.-.P.-.G.-.P.-.-.-
-.-.P.-.P.P.P.-.-.-
P.-.P.-.-.-.-.-.-.-
-.-.P.P.P.-.-.-.P.-
G.-.-.-.P.-.-.-.-.G
